{
	"name": "The Sunken",
	"id": "0",
	"turns": "6",
	"bg": "bg0",
	"author": "",
	"desc": "Das intro Level",
	"data": [
		[ ".", ".", "#", " ", "#", ".", ".", ".", ".", " " ],
		[ ".", ".", ".", "#", ".", ".", "#", ".", "e", " " ],
		[ ".", "#", ".", "+", ".", "p", "#", ".", ".", " " ],
		[ ".", ".", ".", ".", ".", ".", ".", ".", ".", " " ],
		[ ".", "#", ".", ".", "+", ".", ".", ".", ".", " " ],
		[ " ", " ", " ", " ", " ", " ", " ", " ", " ", " " ],
		[ " ", " ", " ", " ", " ", " ", " ", " ", " ", " " ],
		[ " ", " ", " ", " ", " ", " ", " ", " ", " ", " " ],
		[ " ", " ", " ", " ", " ", " ", " ", " ", " ", " " ],
		[ " ", " ", " ", " ", " ", " ", " ", " ", " ", " " ]
	]
}
