{
	"name": "The River",
	"id": "9",
	"turns": "10",
	"bg": "bg0",
	"author": "",
	"desc": "Das intro Level",
	"data": [
		[ ".", ".", ".", ".", ".", "#", ".", ".", ".", "." ],
		[ ".", "p", ".", ".", ".", "#", ".", ".", ".", "." ],
		[ "h", "h", "h", "V", "h", "c", ".", ".", ".", "." ],
		[ ".", ".", ".", ".", ".", "v", ".", ".", ".", "." ],
		[ ".", ".", ".", ".", ".", "H", ".", ".", "e", "." ],
		[ ".", ".", ".", ".", ".", "c", "h", "h", "h", "h" ],
		[ " ", " ", " ", " ", " ", " ", " ", " ", " ", " " ],
		[ " ", " ", " ", " ", " ", " ", " ", " ", " ", " " ],
		[ " ", " ", " ", " ", " ", " ", " ", " ", " ", " " ],
		[ " ", " ", " ", " ", " ", " ", " ", " ", " ", " " ]
	]
}