{
	"name": "Mess Of Bridges",
	"id": "11",
	"turns": "24",
	"bg": "bg0",
	"author": "",
	"desc": "Das intro Level",
	"data": [
		[ "V", "H", "h", "c", "h", "c", "c", ".", "H", "." ],
		[ "V", "p", "c", ".", "v", "h", "c", "H", "#", "C" ],
		[ "V", "c", "h", "c", "h", "c", "H", "V", "#", "H" ],
		[ "H", ".", "c", "v", "v", "H", "V", "H", "c", "." ],
		[ "V", "H", "H", "c", "H", "V", "h", "h", "e", "V" ],
		[ "c", "v", "V", "H", "V", "h", "c", "v", "h", "v" ],
		[ " ", " ", " ", " ", " ", " ", " ", " ", " ", " " ],
		[ " ", " ", " ", " ", " ", " ", " ", " ", " ", " " ],
		[ " ", " ", " ", " ", " ", " ", " ", " ", " ", " " ],
		[ " ", " ", " ", " ", " ", " ", " ", " ", " ", " " ]
	]
}