{
	"name": "Risky Waters",
	"id": "11",
	"turns": "21",
	"bg": "bg0",
	"author": "",
	"desc": "Das intro Level",
	"data": [
		[ ".", ".", ".", ".", "#", "e", ".", ".", "H", "." ],
		[ ".", "p", ".", ".", ".", "#", " ", " ", "#", "." ],
		[ "h", "h", "h", "V", "h", "c", ".", ".", "#", "." ],
		[ ".", ".", ".", ".", ".", "H", ".", ".", "v", "." ],
		[ ".", ".", ".", ".", "#", "c", "h", "h", "h", "V" ],
		[ ".", ".", ".", ".", ".", ".", ".", ".", ".", "." ],
		[ " ", " ", " ", " ", " ", " ", " ", " ", " ", " " ],
		[ " ", " ", " ", " ", " ", " ", " ", " ", " ", " " ],
		[ " ", " ", " ", " ", " ", " ", " ", " ", " ", " " ],
		[ " ", " ", " ", " ", " ", " ", " ", " ", " ", " " ]
	]
}