{
	"name": "The End?",
	"id": "13",
	"turns": "21",
	"bg": "bg1",
	"author": "",
	"desc": "Das intro Level",
	"data": [
		[ ".", ".", ".", ".", "v", ".", ".", ".", ".", "." ],
		[ ".", "p", ".", ".", "H", ".", ".", "K", ".", "." ],
		[ ".", ".", ".", ".", "v", ".", ".", ".", ".", "." ],
		[ "h", "c", "h", "h", "c", "h", "h", "h", "V", "h" ],
		[ "L", "v", ".", ".", ".", ".", ".", ".", ".", "." ],
		[ ".", "H", ".", ".", ".", ".", ".", ".", ".", "." ],
		[ " ", "v", " ", " ", " ", " ", " ", " ", " ", " " ],
		[ " ", " ", " ", " ", " ", " ", " ", " ", " ", " " ],
		[ " ", " ", " ", " ", " ", " ", " ", " ", " ", " " ],
		[ " ", " ", " ", " ", " ", " ", " ", " ", " ", " " ]
	]
}