{
	"name": "The Sunken",
	"id": "3",
	"turns": "10",
	"bg": "bg0",
	"author": "",
	"desc": "Das intro Level",
	"data": [
		[ ".", "e", "#", " ", " ", ".", ".", ".", ".", " " ],
		[ ".", "#", ".", "#", ".", ".", "#", ".", ".", " " ],
		[ ".", "#", ".", "+", ".", "p", "#", ".", ".", " " ],
		[ ".", ".", ".", ".", ".", ".", ".", ".", ".", " " ],
		[ ".", "#", ".", ".", "+", "x", ".", ".", ".", " " ],
		[ " ", " ", " ", " ", " ", " ", " ", " ", " ", " " ],
		[ " ", " ", " ", " ", " ", " ", " ", " ", " ", " " ],
		[ " ", " ", " ", " ", " ", " ", " ", " ", " ", " " ],
		[ " ", " ", " ", " ", " ", " ", " ", " ", " ", " " ],
		[ " ", " ", " ", " ", " ", " ", " ", " ", " ", " " ]
	]
}