{
	"name": "The Sunken",
	"id": "4",
	"turns": "7",
	"bg": "bg0",
	"author": "",
	"desc": "Das intro Level",
	"data": [
		[ ".", ".", "#", " ", "#", ".", ".", ".", ".", " " ],
		[ ".", ".", ".", "#", ".", ".", "#", ".", ".", " " ],
		[ ".", "#", ".", "x", ".", "p", "#", ".", ".", " " ],
		[ ".", ".", ".", ".", "#", ".", ".", ".", ".", " " ],
		[ "e", "#", ".", ".", "+", " ", ".", ".", ".", " " ],
		[ " ", " ", " ", " ", " ", " ", " ", " ", " ", " " ],
		[ " ", " ", " ", " ", " ", " ", " ", " ", " ", " " ],
		[ " ", " ", " ", " ", " ", " ", " ", " ", " ", " " ],
		[ " ", " ", " ", " ", " ", " ", " ", " ", " ", " " ],
		[ " ", " ", " ", " ", " ", " ", " ", " ", " ", " " ]
	]
}