{
	"name": "The Sunken",
	"id": "4",
	"turns": "20",
	"bg": "bg0",
	"author": "",
	"desc": "Das intro Level",
	"data": [
		[ ".", ".", "#", " ", "#", ".", ".", ".", ".", " " ],
		[ ".", ".", ".", "#", ".", ".", "#", ".", ".", " " ],
		[ ".", "#", ".", "+", ".", "p", "#", ".", ".", " " ],
		[ ".", ".", ".", ".", "e", ".", ".", ".", ".", " " ],
		[ ".", "#", ".", ".", "+", "x", ".", ".", ".", " " ],
		[ " ", " ", " ", " ", " ", " ", " ", " ", " ", " " ],
		[ " ", " ", " ", " ", " ", " ", " ", " ", " ", " " ],
		[ " ", " ", " ", " ", " ", " ", " ", " ", " ", " " ],
		[ " ", " ", " ", " ", " ", " ", " ", " ", " ", " " ],
		[ " ", " ", " ", " ", " ", " ", " ", " ", " ", " " ]
	]
}