{
	"name": "The Sunken",
	"id": "4",
	"turns": "12",
	"bg": "bg0",
	"author": "",
	"desc": "Das intro Level",
	"data": [
		[ ".", ".", "#", " ", "#", ".", ".", "l", ".", " " ],
		[ ".", ".", ".", "#", ".", ".", "#", "#", "#", " " ],
		[ ".", "#", ".", "x", ".", "p", "#", "k", ".", " " ],
		[ ".", ".", ".", ".", "#", ".", ".", ".", ".", " " ],
		[ ".", "#", ".", ".", "+", " ", ".", ".", ".", " " ],
		[ " ", " ", " ", " ", " ", " ", " ", " ", " ", " " ],
		[ " ", " ", " ", " ", " ", " ", " ", " ", " ", " " ],
		[ " ", " ", " ", " ", " ", " ", " ", " ", " ", " " ],
		[ " ", " ", " ", " ", " ", " ", " ", " ", " ", " " ],
		[ " ", " ", " ", " ", " ", " ", " ", " ", " ", " " ]
	]
}