{
	"name": "All Those Dead...",
	"id": "4",
	"turns": "12",
	"bg": "bg0",
	"author": "",
	"desc": "Das intro Level",
	"data": [
		[ "+", ".", "#", " ", "#", ".", ".", ".", "p", "." ],
		[ "x", ".", ".", ".", ".", ".", "#", "+", "#", "." ],
		[ ".", "+", ".", "x", ".", ".", ".", "+", ".", "." ],
		[ ".", ".", ".", "+", "#", ".", "+", ".", "x", "." ],
		[ "e", "#", "+", ".", " ", ".", ".", ".", "+", "." ],
		[ ".", ".", ".", ".", ".", ".", ".", ".", ".", "." ],
		[ " ", " ", " ", " ", " ", " ", " ", " ", " ", " " ],
		[ " ", " ", " ", " ", " ", " ", " ", " ", " ", " " ],
		[ " ", " ", " ", " ", " ", " ", " ", " ", " ", " " ],
		[ " ", " ", " ", " ", " ", " ", " ", " ", " ", " " ]
	]
}