{
	"name": "Long Way",
	"id": "5",
	"turns": "14",
	"bg": "bg0",
	"author": "",
	"desc": "Das intro Level",
	"data": [
		[ "#", ".", "#", " ", "#", ".", ".", ".", "p", " " ],
		[ "x", ".", "#", ".", ".", ".", "#", "#", "#", " " ],
		[ "e", "+", ".", "x", ".", ".", ".", "+", ".", " " ],
		[ ".", ".", ".", ".", "#", ".", ".", ".", "x", " " ],
		[ ".", "#", "+", ".", ".", ".", ".", ".", ".", " " ],
		[ " ", " ", " ", " ", " ", " ", " ", " ", " ", " " ],
		[ " ", " ", " ", " ", " ", " ", " ", " ", " ", " " ],
		[ " ", " ", " ", " ", " ", " ", " ", " ", " ", " " ],
		[ " ", " ", " ", " ", " ", " ", " ", " ", " ", " " ],
		[ " ", " ", " ", " ", " ", " ", " ", " ", " ", " " ]
	]
}