{
	"name": "Big Walls",
	"id": "6",
	"turns": "37",
	"bg": "bg0",
	"author": "",
	"desc": "Das intro Level",
	"data": [
		[ "l", "#", ".", "#", ".", "#", ".", "#", ".", "p" ],
		[ ".", "#", ".", "#", ".", "#", ".", ".", ".", "#" ],
		[ ".", ".", ".", "#", ".", ".", ".", "#", "#", "#" ],
		[ ".", "#", ".", "#", ".", "#", ".", "#", "k", "." ],
		[ ".", ".", ".", "#", ".", "#", ".", "#", "#", "." ],
		[ ".", "#", ".", ".", ".", "#", ".", ".", ".", "." ],
		[ " ", " ", " ", " ", " ", " ", " ", " ", " ", " " ],
		[ " ", " ", " ", " ", " ", " ", " ", " ", " ", " " ],
		[ " ", " ", " ", " ", " ", " ", " ", " ", " ", " " ],
		[ " ", " ", " ", " ", " ", " ", " ", " ", " ", " " ]
	]
}