{
	"name": "Where Do I Go Now?",
	"id": "7",
	"turns": "42",
	"bg": "bg0",
	"author": "",
	"desc": "Das intro Level",
	"data": [
		[ ".", "#", ".", "#", ".", "#", ".", "#", ".", "p" ],
		[ ".", ".", ".", "#", ".", "#", ".", ".", ".", "#" ],
		[ ".", "#", ".", "#", ".", "#", ".", "#", "#", "#" ],
		[ ".", "#", ".", ".", ".", "#", ".", "#", "k", "." ],
		[ ".", "l", "#", "#", ".", "#", ".", "#", "#", "." ],
		[ ".", "#", ".", ".", ".", "#", ".", ".", ".", "." ],
		[ "#", "#", ".", "#", "#", "#", " ", "#", "#", "." ],
		[ ".", ".", ".", ".", ".", ".", ".", ".", ".", "." ],
		[ " ", " ", " ", " ", " ", " ", " ", " ", " ", " " ],
		[ " ", " ", " ", " ", " ", " ", " ", " ", " ", " " ]
	]
}