{
	"name": "The Right One",
	"id": "8",
	"turns": "30",
	"bg": "bg0",
	"author": "",
	"desc": "Das intro Level",
	"data": [
		[ "E", "E", "E", "E", "E", "E", "E", "E", "E", "p" ],
		[ "E", "E", "E", "E", "E", "E", "E", "E", "E", "E" ],
		[ "E", "E", "E", "E", "E", "E", "E", "E", "E", "E" ],
		[ "E", "E", "E", "E", "E", "E", "E", "E", "E", "E" ],
		[ "E", "E", "e", "E", "E", "E", "E", "E", "E", "E" ],
		[ "E", "E", "E", "E", "E", "E", "E", "E", "E", "E" ],
		[ " ", " ", " ", " ", " ", " ", " ", " ", " ", " " ],
		[ " ", " ", " ", " ", " ", " ", " ", " ", " ", " " ],
		[ " ", " ", " ", " ", " ", " ", " ", " ", " ", " " ],
		[ " ", " ", " ", " ", " ", " ", " ", " ", " ", " " ]
	]
}